 first_name |    last_name    
------------+-----------------
 Agustin    | Lesch
 Alayna     | Towne
 Alberto    | Hegmann
 Alvena     | Dooley
 Andreane   | Pagac-Mertz
 Andy       | Yundt-Reilly
 Candelario | Hackett
 Candice    | Turner
 Cassie     | D'Amore
 Cicero     | Deckow
 Cielo      | Flatley
 Colton     | Krajcik
 Conor      | Von
 Coy        | Kovacek
 Daisha     | Hessel
 Danielle   | Zieme
 Darrion    | Donnelly-Crona
 Drake      | Rohan
 Eddie      | Bednar
 Eddie      | Casper
 Elyse      | Boyer
 Emely      | Waters
 Enrico     | Corwin
 Esta       | Kuhic
 Ewald      | Hessel
 Fred       | Zulauf
 Fredy      | Kutch
 Giovanna   | Satterfield
 Graham     | Reynolds
 Grover     | Hartmann
 Hettie     | Stark
 Hipolito   | Bernier
 Jamaal     | Boyle
 Jasmin     | Wuckert
 Kenny      | Grant
 Kiley      | Sanford
 Ladarius   | Stanton
 Lessie     | Fay
 Linda      | Herzog
 Luigi      | Sanford
 Magdalen   | Turner
 Mattie     | Emmerich
 Maurine    | Brakus
 Mayra      | Huel
 Nelle      | Braun
 Ofelia     | Mante-Lesch
 Omari      | Huel-Bechtelar
 Pearl      | Mayert
 Reggie     | Gutkowski
 Ressie     | Gutmann-Volkman
 Rey        | Jast
 River      | Harvey
 Ryan       | Langworth
 Serena     | Tillman
 Simone     | Streich
 Tremayne   | Mann-McClure
 Trycia     | Yundt
 Tyshawn    | Abbott-Ritchie
 Willy      | Spencer
 Zoila      | Zboncak
(60 rows)

